20
1,1,5,9,0
2,1,5,9,1
7,1,5,9,2
8,1,5,9,3
1,1,5,9,4
2,1,5,9,5
7,1,5,9,6
8,1,5,9,7
1,1,5,9,0
2,1,5,9,1
7,1,5,9,2
8,1,5,9,3
1,1,5,9,4
2,1,5,9,5
7,1,5,9,6
1,1,5,9,7
2,1,5,9,0
7,1,5,9,1
8,1,5,9,2
1,1,5,9,3