30
1,1,5,1,5
2,1,5,2,6
7,1,5,1,7
8,1,5,2,8
1,1,5,1,5
2,1,5,2,6
7,1,5,1,7
8,1,5,2,8
1,1,5,1,5
2,1,5,2,6
7,1,5,1,7
8,1,5,2,8
1,1,5,1,5
2,1,5,2,6
7,1,5,1,7
1,1,5,2,8
2,1,5,1,5
7,1,5,2,6
8,1,5,1,7
1,1,5,2,8
2,1,5,1,5
7,1,5,2,6
8,1,5,1,7
1,1,5,2,8
2,1,5,1,5
1,1,5,2,6
2,1,5,1,7
7,1,5,2,8
8,1,5,1,5
1,1,5,2,6